1111111111111111111111111
1000100000000100000011111
10000111111000001C0000001
1000P10000000011111000001
1000011111111110000000001
1000000000000000000000001
1111111111110000000000001
1000000E0000000000000C001
1111111111111111111111111
