1111111111111111111111111
10001000000M0100000011111
1M000111111000001C0000001
10000100P0000011111000001
1000011111111110000000001
1000000000000000000000001
11111111111100000000M0001
1000000E0000000000000C001
1111111111111111111111111
