111111
1C0P01
100101
100101
1001E1
111111
